DOCUMENTO 320 COMUNICACION DEL GOBIERNO DIRIGIDA AL ARZOBISPO NARCISO COLL Y PRAT, FECHADA EN VALENCIA EL 25 DE AGOSTO DE 1813, RELATIVA A LA PROVISION DEL CURATO DE LA GUAIRA, Y, EN TERMINOS GENERALES, A LA COOPERACION DEL PODER ECLESIASTICO CON EL CIVIL* -

Portada del sitio > 4) Periodo (07AGO AL 31DIC 1813) Correspondencia Oficial > DOCUMENTO 320 COMUNICACION DEL GOBIERNO DIRIGIDA AL ARZOBISPO ()

DOCUMENTO 320 COMUNICACION DEL GOBIERNO DIRIGIDA AL ARZOBISPO NARCISO COLL Y PRAT, FECHADA EN VALENCIA EL 25 DE AGOSTO DE 1813, RELATIVA A LA PROVISION DEL CURATO DE LA GUAIRA, Y, EN TERMINOS GENERALES, A LA COOPERACION DEL PODER ECLESIASTICO CON EL CIVIL*

Ilustrisimo Senor Arzobispo:

He dado cuenta al General en Jefe de estos Estados del Oficio de VS lima, de 21 del corriente por el que, en contestacion al mio de 19 del mismo, acompana veinte y dos ordenes a fin de que, examinadas, se las curse y manifiesta la provision interina en D Juan de Dios Echarri para La Guaira en consecuencia de otro del 13 a quien mientras se aposesiona sustituye el Reverendo Padre Fray Santiago Salamanca, por la insinuacion que al segundo hizo el Comandante General; y que su propietario Dn Jose Joaquin de la Sierra se mantiene al lado de VS Ilma

El General en Jefe me manda le diga cuan satisfactorio le ha sido, la franca y generosa disposicion que le manifiesta, en contribuir eficazmente como lo esperaba, a consolidar la paz tan necesaria para consolidar un Gobierno estable y permanente; y se lisonjea que continuando VS lima, en tan santo proposito nada le queda que desear

En esta confianza y siendo repetidos los clamores que se le hacen sobre otros Eclesiasticos que directamente conspiran contra nuestro actual sistema de que por su poderoso influjo debe temerse con fundamento nuevo trastorno y confusion por el que decididamente tienen sobre la gente incauta de su feligresia, me manda haga presente a VS lima, lo necesario e importantisimo que es se releven por ahora algunos de ellos, que son los que comprende la lista que acompano, privandoles tambien de las licencias de predicar y confesar y mandandoles comparezcan en esa Capital, despues que hayan sido sustituidos por los que expresa la misma lista

En cuanto a la dificultad que presenta la sustitucion de los Padres Capuchinos que volvieron a las Misiones secularizadas por hallarse sus Curas propietarios ejerciendo estas funciones en otros Pueblos Confiado el General en el ardiente celo y decidido interes de V S lima, por nuestra sagrada Causa, espera se sirva decirle que sacerdotes seculares y regulares seran los mas a proposito para estos y otros Curatos en el supuesto que, sobre reunir las cualidades necesarias para su ministerio, sean unos verdaderos amantes de la Causa de Venezuela

Cree tambien y aprecia en grande manera la indicacion de VS lima, que convendra separar, por ahora, igualmente a los Capuchinos encomendados en aquellos Pueblos de otras Misiones que no estan secularizadas y que vengan a su Hospicio y se verificara asi luego que tenga a la vista la lista de sacerdotes que VS lima, le insinue ser mas a proposito

Cuartel General de Valencia, agosto 25 de 1813, 3° de la Independencia y 1° de la guerra a muerte

RAFAEL D MERIDA

[Al margen:] Tengase reservada y expidase las ordenes convenientes en cuanto a los Eclesiasticos meramente idoneos para el ejercicio de dura en los lugares a que son propuestos

ANEXO

Sacerdotes seculares y regulares que en calidad de Coadjutores deben encargarse de los Curatos que se expresan para relevar a los que los tienen

Candelaria: Por el Pbro Dn Antonio Gonzalez, el Dr Dn Manuel Rada

Santa Rosalia: Por el Dr Dn Juan Manuel Dominguez, el Dr Dn Jose Antonio Perez

Barata: Por el Br Dn Pedro Manuel Mesa, el Pbro Dn Esteban Zembi

Valle: Por el Dr Dn Vicente Hermoso, el Pbro Dn Enrique II lescas

Santa Lucia: Por Francisco Pereyra Alvarez, el R Padre Fray Juan A Navarrete

Caraballeda: Por el Pbro Dn Domingo Delgado, el Pbro Dn Miguel Caballero

Tarmas: Por el Pbro Dn Jose Felix Freytes, el Pbro Dn Jose de Jesus Caraballo

Carayaca: Por el Pbro Br Dn Francisco Ribera, el RP Fray Juan Abreu

Tocuyo: Por el Dr Dn Jose Vicente Vergara, el Dr Dn N Pcrera

Humocaro Alto y Bajo y Barbacoas: Por el Pbro Dn Jeronimo Gamboa, el Pbro Dn Francisco Gil

Quibor: Por el Br Dn Jose Pio Anzola, el Pbro Dn Domingo Castcjon

Chabasquen: Por el Pbro Dn Pedro Juan Perez, el P i N Arocha

El Pao en San Carlos: Por el Pbro Dn Nicolas Castro, el Pbro Dn Ramon Amitesarovc

San Jose: Por el Pbro Dr Dn Rafael Bergolla, el que es Coadjutor Dn Juan Ramon Quintana

Tucupido y Maraca: Por el Pbro Dn Jose Gabriel Diaz y Dn Manuel Cipriano Sanchez, el Pbro Dn Vicente Jaen, Cura de Bocono

Villa de Ospino: Por el Dr Dn Jose Damian Acosta, el Pbro Dn Jose M Magdaleno

Jujure: Por el Pbro Dn Jose Manuel Vargas, el Pbro Dn Narciso Pelayo

Acarigua: Por el Pbro Dn Jose Maria Luna, el Pbro Dn Jose’ Maria Tirado

Canoabo, Alpargaton y Moron: Por el Br Dn Juan Jose Reyna y Pbro Dn Jose Rafael Diaz, el Pbro Dn Felix Paez

Yaritagua: Por el Pbro Dn Ignacio Pimental, el R P Fray Tomas Llorente

San Jose de Tiznados: Por el Dr Dn Gabriel Mata, el Pbro Dn Jose Miguel Fernandez Feo

Turmero: Por el Br Dn Pedro Alvarez, el RP Fray Francisco Gonzalez

Valencia: Por el Br Dn Juan Jose Landaeta, Coadjutor, el Pbro Dn Pedro Julian Gonzalez

Santa Cruz: Por el Br Dn Manuel Antonio Faxardo, el Pbro Dn Jose M Zevallos

Guardatinajas: Por el Pbro Dn Jose Manuel Gonzalez, si no puede servir personalmente, el Pbro Maestro Jose Antonio Armada

Calvario: Por el Br Dn Ramon Windervoxhel, el Pbro Dr Jose Antonio Sanes

Barbacoas: Por el Pbro Jose Tomas Fernandez, el mismo Pbro Sanes

Patanemo y Turiamo: Por los Pbros Dn Miguel Vazquez y Dn Guillermo Espinoza, el Pbro Dn Jacinto Machado, Cura de Borburata

Camaguan: Por Dn Jose Francisco Quintana, el Pbro Dr Juan Felix Arana

Santa Teresa: Por el Pbro Dr Jose Antonio Garcia, el P Pablo Hernandez

San Sebastian: Por el Dr Dn Jose Aguado de Suarez, el Pbro Dn Bruno Infante

Ortiz: Por el Br Dn Jose Jacinto Osio, el Pbro Dn Justo Antonio Fuentes

San Rafael de Orituco: Por el Pbro Dn Antonio de la Paz Sanchez, el Pbro Dn Francisco Aponte, Cura de Altagracia

San Juan de los Morros: Por el Br Dn Antonio Diaz Argote, el Pbro Dn Jose Fuentes

Baul: Por Dn Antonio Perez Guzman, el Pbro Dn Juan Vicente Cisneros

Cata y Ocumarc de la Costa: Por el Pbro Br Dn Luis Guzman y R P Fr Manuel Montano, el Pbro Dn Francisco Padron

Caucagua: Por Dn Jose de Jesus Yanes, interino, el Dr Dn Miguel Antonio Castro

Guanarito: Por el Pbro Dn Gabriel Cayetano Lindo, el Pbro Dn Bartolome Gonzalez

Cuartel General de Valencia, Agosto 25 de 1813, 3° de la Independencia y 1° de la guerra a muerte

MERIDA

* De un impreso moderno El Pbro Jaime Suria, quien fue Director del Archivo Arquidiocesano de Caracas, publica este documento y la lista anexa en su obra, Iglesia y Estado, 1810-1821, Caracas, 1967, pp 162-166 La Comision Editora no ha podido examinar el original manuscrito


